# Page 49 Column 1
daks'und	dachshund
dafdel	daffodil
dagtip	daguerreotype
dante	dainty
!	daintier
!	daintiest
dante|	daintily
daleans	dalliance
tmj	damage
tmjd	damaged
n-dmef	indemnify
ntmjd	undamaged
tmas(k	damask
damp	damp
dmpn	dampen
dampne~	dampener
!	damper
!	dampness
dans	dance
!	danced
danser	dancer
tndelin	dandelion
tnde	dandy
tnje~	danger

# Page 49 Column 2
tnjus	dangerous
tnje~s	dangers
ntnje~d	endangered
da~	dare
da~d	dared
!	dares
dark	dark
darkn	darken
darknes	darkness
dta	data
datm	datum
td	date
td^t	dated
ntd^t	undated
datv	dative
dote~	daughter
dotelo	daughter-in-law
g^dote~	granddaughter
dont	daunt
dontl	dauntless
n-dont^t	undaunted
dfnpot	davenport
davt	davit
da	day
!	daydream

# Page 49 Column 3
dali	daylight
das	days
datm	daytime
dazl	dazzle
!	dazzled
td	dead
tdn	deaden
tdnt	deadened
tdi	deadeye
tdfo	deadfall
tdenes	deadliness
def	deaf
!	deafened
defnes	deafness
de~	deal
de~^r	dealer
dels	deals
!	dealt
de~	dear
de~^r	dearer
de~^s(t	dearest
de~e	dearly
!	dears
!	deary
n-de~d	endeared

# Page 50 Column 1
deth)	dearth
deth	death
!	deathbed
!	deathless
!	deathlike
!	deathly
db^k	debacle
dba	debate
!	debatable
dbat-d	debated
dbate~	debater
dbentr	debenture
dbeleta	debilitate
!	debilitated
dbletsh	debilitation
d^b	debility
dbna~	debonair
td	debt
dbt	debit
tde~	debtor
ntd^t-nes	indebtedness
!	d√©but
dekad	decade
dekadns	decadence
dekalk	decalcomania

# Page 50 Column 2
dekte~	decanter
dekap	decapitate
!	decapitation
!	decathlon
dses	decease
!	deceased
ds(etn	decedent
d-set	deceit
d-set-f	deceitful
dse	deceive
!	deceiver
dses	deceives
dsepsh	deception
dsepdf	deceptive
ds(ent	decent
dsense	decency
!	decently
!	indecency
nts(ent	indecent
ds(i	decide
dsi^te	decidedly
ds(is	decides
dsesh	decision
ds(isv	decisive
ds(isve	decisively

# Page 50 Column 3
!	decisiveness
ntsesh	indecision
n-dsi^t	undecided
ds(eml	decimal
!	decimate
ds(if	decipher
ds(ifb	decipherable
uds(ifb	undecipherable
de^m	declaim
de-msh	declamation
!	declamatory
de^r	declare
de-rb	declarable
de^rsh	declaration
de^rdf	declarative
!	declaratory
dklin	decline
de^nsh	declension
de^nt	declined
de^v	declivity
n-klin	incline
re^n	recline
dekksh	decoction
dekpo	decompose
!	decomposed

# Page 51 Column 1
dekposh	decomposition
dekra	decorate
dekrash	decoration
dekratv	decorative
dekratr	decorator
dekorm	decorum
dekorus	decorous
dekoe	decoy
!	decoyed
dekres	decrease
!	decreased
dekre	decree
dekrept	decrepit
dekreptu	decrepitude
tdekat	dedicate
tdkash	dedication
ddekator	dedicator
!	dedicatory
tdus	deduce
!	deduces
tdusb	deducible
tduk	deduct
!	deductible
tduksh	deduction
!	deductively

# Page 51 Column 2
ded	deed
!	deeded
!	misdeed
dep	deep
depn	deepen
!	deepness
dpth	depth
de~	deer
dfas	deface
efas	efface
dfalk	defalcate
dfalsh	defalcation
!	defalcator
dfam	defame
dfamsh	defamation
!	defamatory
dfot	default
dfot-d	defaulted
dfote~	defaulter
dfet	defeat
dfet-d	defeated
dfek	defect
dfeksh	defection
dfekv	defective
dfnt	defend

# Page 51 Column 3
dft	defendant
dfntd	defended
dfntr	defender
dfens	defense
dfensl	defenseless
!	defensible
dfensv	defensive
dfr	defer
dfrens	deference
dfrensh	deferential
dfeshse	deficiency
dfesht	deficient
dfes(et	deficit
dfil	defile
dfin	define
dfinb	definable
dfn	definite
dfn-n	definiteness
dfnsh	definition
dfnedf	definitive
n-dfinb	indefinable
!	indefinitely
dfla	deflate
dflash	deflation
dfm	deform

# Page 52 Column 1
!	deformed
d-f^mt	deformity
dfrod	defraud
!	defrauded
dfra	defray
!	defrayal
dft	deft
dfnk	defunct
dfi	defy
dfins	defiance
dfint	defiant
dfid	defied
djenra	degenerate
djense	degeneracy
djenrsh	degeneration
degra	degrade
degradsh	degradation
degrad	degraded
deg	degree
didra	dehydrate
def	deify
!	deification
!	deifies
des(m	deism
des(t	deist

# Page 52 Column 2
dete	deity
djk	deject
djkte	dejectedly
djksh	dejection
dla	delay
delektb	delectable
dlektsh	delectation
del	delegate
delsh	delegation
dlet	delete
dlesh	deletion
dleter	deleterious
dleb	deliberate
!	deliberately
dlebsh	deliberation
dleb^v	deliberative
delek	delicate
delekse	delicacy
delekes(n	delicatessen
ntelek	indelicate
dleshus	delicious
dli	delight
dlid	delighted
dlif	delightful
dlenat	delineate

# Page 52 Column 3
dlensh	delineation
dlenatr	delineator
dlenk	delinquent
!	delinquency
dlerm	delirium
dler	delirious
dl	deliver
dlb	deliverable
dlns	deliverance
dl^r	deliverer
dl	delivery
!	undeliverable
dlud	delude
dlud-d	deluded
dlush	delusion
dlusv	delusive
delj	deluge
tmag	demagogue
tman	demand
tmrkash	demarcation
tmene~	demeanor
demn^t	demented
demnsha&'	dementia
dme~t	demerit
tmis	demise

# Page 53 Column 1
tmoblis	demobilize
tmoblisash	demobilization
tmoblisd	demobilized
tmr	democrat
tmkse	democracy
tmk	democratic
tmke	democratically
tmolsh	demolish
tmolesh	demolition
demn	demon
demnetiz	demonetize
!	demonetization
tmons	demonstrate
dmonsb	demonstrable
dmons^v	demonstrative
tmonsr	demonstrator
dmoliz	demoralize
dmolez-sh	demoralization
!	demoralized
tmur	demur
!	demurrer
tmurj	demurrage
tmeur	demure
tnatr	denature
tnem	denim

# Page 53 Column 2
tnes(en	denizen
tnomnat	denominate
!	denominated
tnomnsh	denomination
dnomnatr	denominator
dnot	denote
dnns	denounce
!	denouncement
!	denouncer
dnunsash	denunciation
!	denunciatory
tns	dense
tn^s	density
dn-tl	dental
tntes	dentist
tntesre	dentistry
tni	deny
tnil	denial
tnid	denied
!	denier
tnis	denies
n-dni	undeniable
doderis	deodorize
dpt	depart
apt-m	apartment

# Page 53 Column 3
kpt-m	compartment
dpt-m	department
dpt^m	departmental
dptr	departure
djnt	depend
djntb	dependable
djntd	depended
djntns	dependence
djntnt	dependent
ntp	independence
ntp	independent
dpk	depict
!	depicted
dplet	deplete
dplet-d	depleted
dplesh	depletion
dplr	deplore
dplr^b	deplorability
dplrb	deplorable
dpon	deponent
dpop^u	depopulate
dpot	deport
!	deportation
!	deported
dporm	deportment

# Page 54 Column 1
dpo	depose
dpos	deposes
dpos	deposit
dpos^re	depositary
dposh	deposition
dpos^r	depositor
dpos^re	depository
dpo	depot
dprav	deprave
!	depravation
dpr^v	depravity
dprek	deprecate
dpreksh	deprecation
dprek^re	deprecatory
dpresha&'t	depreciate
dpresha&'sh	depreciation
dpredsh	depredation
dpres	depress
dpresnt	depressant
dpressh	depression
dpresv	depressive
dpri	deprive
dprivash	deprivation
privash	privation
dpth	depth

# Page 54 Column 2
dpu	depute
dpush	deputation
dputiz	deputize
dpute	deputy
dranj	derange
dranjm	derangement
derlek	derelict
!	dereliction
dri	deride
deresh	derision
!	derisive
dri	derive
dervash	derivation
drev	derivative
derogsh	derogation
drogv	derogative
derog	derogatory
derek	derrick
ds(en	descend
as(en	ascend
ds(entn	descendant
ds(ent	descent
ds(kr	describe
dskrb	describable
ds(krsh	description

# Page 54 Column 3
ds(krv	descriptive
ds(kra	desecrate
dskrash	desecration
ds(e~t	desert
!	deserted
ds(ete~	deserter
ds(esh	desertion
ds(ev	deserve
dsevde	deservedly
n-dsevd	undeserved
deskat	desiccate
!	desiccation
!	desiccator
ds(in	design
ds(ig	designate
ds(igsh	designation
ds(in-d	designed
ds(inr	designer
ds	desire
dsb	desirable
ds-s	desires
ds(us	desirous
n-dsb	undesirable
dss	desist
!	desisted

# Page 55 Column 1
!	desists
dsola	desolate
!	desolately
dsolash	desolation
dspar	despair
dspard	despaired
dspra	desperate
dsprae	desperately
dsprash	desperation
dspis	despise
dspkb	despicable
dspi	despite
dsjnt	despond
!	despondency
dspond	despondent
dspot	despot
dsp^a	despotic
dsptsm	despotism
ds(e~t	dessert
!	destine
ds(tnsh	destination
ds(tnd	destined
destne	destiny
dstet	destitute
ds(tetsh	destitution

# Page 55 Column 2
ds^oe	destroy
ds^oed	destroyed
ds^oer	destroyer
ds^ksh	destruction
ds^kv	destructive
dse_tu	desuetude
ds(u^re	desultory
!	desultorily
dtach	detach
!	detached
dtachm	detachment
tda~	detail
tdald	detailed
tdtn	detain
!	detained
tdtnsh	detention
tdek	detect
tdekd	detected
tdekv	detective
!	detector
d^	deter
d^nt	deterrent
d^ora	deteriorate
!	deteriorated
d^orash	deterioration

# Page 55 Column 3
e~mn	determine
e~mnsh	determination
e~mn^te	determinedly
ne~mnat	indeterminate
!	predetermined
ne~mn^t	undetermined
tdes	detest
dtesb	detestable
dtes-sh	detestation
dthron	dethrone
!	dethroned
!	detonate
tdonsh	detonation
tdur	detour
d^k	detract
d^ksh	detraction
d^kr	detractor
d^m	detriment
d^ml	detrimental
dfas(ta	devastate
dfas(tash	devastation
dfl	develop
dflr	developer
dflm	development
n-dvl^t	undeveloped

# Page 56 Column 1
d-va&'t	deviate
d-va&'t-d	deviated
d-va&'sh	deviation
devus	devious
dfis	device
!	devised
dfl	devil
dfoe	devoid
dfol	devolve
dfot	devote
dvte	devotee
dvosh	devotion
!	devotional
dvaut	devout
dextrus	dexterous
ambdex	ambidextrous
dex^r	dexterity
dibtes	diabetes
!	diabetic
dib^k	diabolical
dikr^ea	diacritical
ditm	diadem
dirss	diaeresis
dignos	diagnose
dignoss	diagnosis

# Page 56 Column 2
dign^st	diagnostic
dignostsh	diagnostician
dig	diagonal
dige	diagonally
di^g	diagram
di^g^a	diagrammatic
dilek	dialect
dilekks	dialectics
dilog	dialogue
dimete~	diameter
!	diametric
!	diametrically
dimn	diamond
dipas(n	diapason
difnus	diaphanous
difram	diaphragm
!	diatribe
!	dictaphone
dekta	dictate
dektsh	dictation
dekta^r	dictator
!	dictatorial
dekta^re|	dictatorially
deksh	diction
dekzre	dictionary

# Page 56 Column 3
dekt^o	dictograph
dektm	dictum
dekta	dicta
!	dictums
tdaktek	didactic
da&et	diet
!	dietary
!	dietetics
df	differ
df	difference
df	different
dfnsh	differential
!	differentially
dfsha&et	differentiate
dfnsha&'sh	differentiation
dfe	differently
ndf	indifferent
dfk	difficult
dfkes	difficulties
dfke	difficulty
dftn	diffident
dfdns	diffidence
!	diffraction
dfeu	diffuse
!	diffuses

# Page 57 Column 1
!	diffusible
dfeush	diffusion
djes	digest
djesb	digestible
djesh	digestion
djestv	digestive
ntjesh	indigestion
!	undigested
dejt	digit
dejtl	digital
!	digitalis
degnef	dignify
deg^re	dignitary
deg^nt	dignity
nteg^nt	indignity
!	undignified
degres	digress
degresh	digression
!	digressive
dik	dike
delap	dilapidate
delapsh	dilapidation
dila	dilate
dilash	dilation
delatre	dilatory

# Page 57 Column 2
delema	dilemma
delejnt	diligent
delej	diligence
delut	dilute
!	diluted
delsh	dilution
!	undiluted
dem	dim
!	dimly
!	dimmed
!	dimmer
!	dimness
!	undimmed
tmensh	dimension
tmenshl	dimensional
tmensh	diminish
!	diminuendo
dmeneush	diminution
tmeneu	diminutive
!	undiminished
d^m-t	dimity
tmpl	dimple
din	dine
dint	dined
tnr	dinner

# Page 57 Column 3
tnje	dingy
!	dinosaur
tnt	dint
da&ess	diocese
dfthera&'	diphtheria
!	diphtheritic
dfthong	diphthong
!	diphthongal
dploma	diploma
dplomat	diplomat
dplomse	diplomacy
dplom^a	diplomatic
dplomates	diplomatist
deps(omna&'	dipsomania
!	dipsomaniac
di~	dire
dirf	direful
!	direly
drk	direct
drksh	direction
drkns	directness
dr	director
drk^ra	directorate
drk^re	directory
ntrk	indirect

# Page 58 Column 1
!	undirected
derej	dirigible
dsab	disable
dsa^b	disability
dsabeu	disabuse
ds(av	disadvantage
dsavus	disadvantageous
!	disaffected
!	disaffection
da|	disagree
da|b	disagreeable
!	disagreed
da|	disagreement
dsal	disallow
dsapr	disappear
dsaprns	disappearance
doe	disappoint
doem	disappointment
!	disapprobation
dsaprv	disapprove
dsaprvl	disapproval
ds(am	disarm
dsara	disarrange
!	disarticulate
dss(te~	disaster

# Page 58 Column 2
dsstrus	disastrous
!	disavow
!	disavowal
dsband	disband
dsbe	disbelieve
!	disbeliever
dsbrs(m	disbursement
dska~d	discard
dska~d-d	discarded
ds(en	discern
ds(enb	discernible
ds(e~mn	discernment
dschj	discharge
dschjd	discharged
dsip	disciple
dsplenre	disciplinary
dsplen	discipline
dskla	disclaim
!	disclaimed
!	disclaimer
dskls	disclose
!	disclosed
!	discloses
dsklshu	disclosure
!	undisclosed

# Page 58 Column 3
ds(kul	discolor
!	discoloration
dskftr	discomfiture
dskft	discomfort
dskpo	discompose
!	discomposes
dskposhu	discomposure
dsks(et	disconcert
!	disconcertedly
dsktn-t	discontent
dsktn^t	discontented
ds(ktnu	discontinue
!	discontinuance
!	discontinued
ds(kod	discord
kkod	concord
ds(kotn	discordant
des	discount
ds(ktnans	discountenance
ds(krj	discourage
ds(krjd	discouraged
ds(krjm	discouragement
n-krj	encourage
dskrs	discourse
dskrsv	discursive

# Page 59 Column 1
dske~tus	discourteous
ds(kv	discover
ds(kvr	discoverer
ds(kve	discovery
!	discreditable
dskret	discreet
ds(kresh	discretion
ndskre	indiscreet
ds(krep	discrepancy
ds(kremnat	discriminate
!	discriminated
dskremnsh	discrimination
!	discriminatory
ndskrem	indiscriminate
ds(k	discuss
ds(ksh	discussion
dsdan	disdain
dsdan-d	disdained
dsdanf	disdainful
!	diseased
dsmbark	disembark
!	disembarcation
!	disenchant
ds(n-ga	disengage
ds(n-gam	disengagement

# Page 59 Column 2
dsntang	disentangle
dsfa	disfavor
ds(fetr	disfeature
dsfegr	disfigure
ds(franch	disfranchise
ds(gras	disgrace
dsgrasf	disgraceful
dsgis	disguise
n-dsgiz	undisguised
dsgus	disgust
dsabel	dishabille
ds'a~tn	dishearten
dshev	dishevel
dsonr	dishonor
dsones	dishonest
ds(onese	dishonestly
ds(onese	dishonesty
dsonrb	dishonorable
dselsh	disillusion
dse^n	disincline
dse^nsh	disinclination
dse^nd	disinclined
dsnfk	disinfect
ds(nfeknt	disinfectant
!	disingenuous

# Page 59 Column 3
dsen'e~t	disinherit
dsntegra	disintegrate
dsn^sd^	disinterested
dsjoen	disjoin
dsjnk	disjunction
dsjnk	disjunctive
dsla	dislike
dslok	dislocate
dsloj	dislodge
dsloe	disloyal
ds(ml	dismal
ds(mntl	dismantle
dsma	dismay
n-dsmad	undismayed
!	dismember
dsmes	dismiss
dsmesl	dismissal
!	dismissed
ds(mnt	dismount
dsoba	disobey
!	disobedience
ds(obtnt	disobedient
!	disobeyed
ds(obl	disoblige
ds(ode	disorderly

# Page 60 Column 1
dsog	disorganize
dsprj	disparage
!	disparagement
dspara	disparate
dsp^r	disparity
dspashat	dispassionate
dspach	dispatch
dspachd	dispatched
!	dispatcher
dspl	dispel
!	dispelled
dspns	dispense
!	dispensable
!	dispensary
!	dispensation
!	dispensed
dsprs	disperse
!	dispersal
dsprsh	dispersion
dsplasm	displacement
dspot	disport
dspo	dispose
dspol	disposal
!	disposes
dsposh	disposition

# Page 60 Column 2
!	dispossess
dspr	disproportion
dspr	disproportionate
dsprv	disprove
!	disproof
dspu	dispute
dspush	disputation
dspushus	disputatious
!	disputes
n-dspu	undisputed
dskof	disqualify
dsko^f	disqualification
dskes-sh	disquisition
dsre	disregard
dsrpu	disrepute
!	disreputable
dsres	disrespect
dsrp	disrupt
dsrpsh	disruption
dsat	dissatisfy
dsatsh	dissatisfaction
ds(ek	dissect
dseksh	dissection
ds(em	dissemble
dsemnat	disseminate

# Page 60 Column 3
!	dissemination
ds(ent	dissent
dsensh	dissension
!	dissented
dsentr	dissenter
ds(e~t-n	dissertation
ds(etns	dissidence
dsemel	dissimilar
!	dissimilarity
!	dissimulate
dsepa	dissipate
ds(osht	dissociate
dsolut	dissolute
ds(olb	dissoluble
ds(olsh	dissolution
nts(olb	indissoluble
dsonant	dissonant
dsonans	dissonance
dsa_d	dissuade
dsa_sh	dissuasion
prsa_	persuade
!	suasion
ds(tnt	distant
ds(tns	distance
dstas	distaste

# Page 61 Column 1
dstasf	distasteful
ds(tnd	distend
!	distensible
!	distension
dste~	distill
!	distillate
!	distillation
!	distillery
ds(t	distinct
ds(tsh	distinction
dstn^v	distinctive
ds(t	distinguish
dst^b	distinguishable
nts(t	indistinct
nts(tb	indistinguishable
ds(tot	distort
!	distorted
dstorsh	distortion
ds^k	distract
ds^n	distrain
ds^t^	distraught
ds^s	distress
!	distressed
ds^b	distribute
ds^bsh	distribution

# Page 61 Column 2
ds^btv	distributive
!	distributor
reds^b	redistribute
!	undistributed
ds^k	district
!	redistricted
ds(trs	distrust
ds(trsd	distrusted
ds(trsf	distrustful
ds(tb	disturb
dstbns	disturbance
!	disturbed
!	disturber
n-dstbd	undisturbed
ds(eu	disuse
tdo	ditto
da&enl	diurnal
divg	divagate
!	divagation
divan	divan
dfej	diverge
dfej	divergence
dfejnt	divergent
divrs	divers
dfes	diverse

# Page 61 Column 3
!	diversification
dvesf	diversify
dversh	diversion
dveste	diversity
dfe~t	divert
dfes	divest
dfid	divide
dfid-d	divided
dftn	dividend
dvide~	divider
dvesb	divisible
dfesh	division
!	divisor
ndfesb	indivisible
n-dvi^t	undivided
dfin	divine
dfensh	divination
dfint	divined
df^nt	divinity
dfos	divorce
!	divorc√©e
dflj	divulge
dese	dizzy
!	dizzily
!	dizziness

# Page 62 Column 1
dosel	docile
dos^l	docility
doket	docket
doka~d	dockyard
dr	doctor
dr^at	doctorate
dokt	doctrine
!	doctrinaire
dokt^l	doctrinal
dokm	document
dokmre	documentary
doj	doge
dogma	dogma
dogm^a	dogmatic
dogmatiz	dogmatize
!	doldrums
do	dollar
domn	domain
tm^s(t	domestic
tm^s(ta	domesticate
!	domesticated
tmes^s	domesticity
tmsel	domicile
domnat	dominate
domnans	dominance

# Page 62 Column 2
domnant	dominant
domnsh	domination
domne~	domineer
domnun	dominion
predomnat	predominate
domno	domino
donat	donate
!	donated
donsh	donation
donr	donor
donke	donkey
dor	door
dora_	doorway
dora~d	dooryard
domnt	dormant
dome~	dormer
dometre	dormitory
domaus	dormouse
db	double
dau	doubt
daud	doubted
dauf	doubtful
daul	doubtless
daus	doubts
n-dau^t	undoubted

# Page 62 Column 3
daur	dower
dauje~	dowager
d-n	down
d-n-kas	downcast
d-nfo	downfall
d-nri	downright
d-n^d	downward
dox^o(	doxology
dus(n	dozen
drf	draft
dragn	dragon
!	dragoon
dranj	drainage
drama	drama
dram^a	dramatic
dramates	dramatist
dramatissh	dramatization
dramatis	dramatize
drapre	drapery
dr^s(t	drastic
dro	draw
!	drawback
!	drawbridge
!	drawee
dror	drawer

# Page 63 Column 1
dron	drawn
dred	dread
dre^t	dreaded
dred-f	dreadful
drednot	dreadnaught
drem	dream
dremt	dreamed
dreme~	dreamer
!	dreamily
dreft	drift
driva^n	driveway
!	dromedary
drup	droop
drop	drop
draut	drought
drn	drown
!	drowned
drj	drudge
drjre	drudgery
drug	drug
drges	druggist
drm	drum
drnk	drunk
drnka~d	drunkard

# Page 63 Column 2
!	drunken
!	drunkenness
dri	dry
!	drier
!	driest
!	dryly
drin	dryness
!	dry-shod
dul	dual
dubi	dubiety
dubus	dubious
ntbtb	indubitable
dches	duchess
duktl	ductile
dukt^l	ductility
dul	duel
due	duly
!	unduly
d-m	dumb
d-mp	dump
tnjn	dungeon
dplex	duplex
dup	duplicate
dupsh	duplication

# Page 63 Column 3
dupr	duplicator
dups	duplicity
drb	durable
dr^b	durability
dr	during
drash	duration
dust	dust
tde	duty
tdus	duteous
tdeb	dutiable
tdes	duties
dtef	dutiful
!	undutiful
do_rf	dwarf
de_l	dwell
de_lt	dwelt
de_ndl	dwindle
!	dwindled
dinmk	dynamic
dinami	dynamite
dinamo	dynamo
dinas	dynasty
dspepsi	dyspepsia
dspep	dyspeptic

