# Page 86 Column 1
gab	gable
gaj	gage
gan	gain
gant	gained
!	gainful
!	gainsay
!	galaxy
gol	gall
galant	gallant
galantre	gallantry
glre	gallery
galn	gallon
galp	gallop
glvniz	galvanize
!	galvanism
!	galvanization
gambt	gambit
gamb	gamble
gamb^t	gambled
!	gambler
gamut	gamut
ganglen	ganglion
gangren	gangrene
!	gangrenous

# Page 86 Column 2
ganga_	gangway
gap	gap
garash	garage
grb	garb
garbj	garbage
!	garble
ga~dnr	gardener
gagoel	gargoyle
grland	garland
!	garlic
garm	garment
!	garner
grnet	garnet
grnesh	garnish
garnshe	garnishee
!	garnisher
grneshm	garnishment
garnetr	garniture
gars(n	garrison
grlus	garrulous
gar^l	garrulity
ga~te~	garter
gaslen	gasoline
gasp	gasp
gastrk	gastric

# Page 86 Column 3
gas(tron-k	gastronomic
gat	gate
!	gatehouse
!	gatekeeper
!	gatepost
gata_	gateway
gath	gather
gathd	gathered
!	gatherer
gode	gaudy
!	gauge
!	gauger
gontle	gauntlet
goz	gauze
ga	gay
gate	gayety
!	gayly
!	gayness
gasel	gazelle
gas(et	gazette
jelatn	gelatin
!	gelatinize
jelatnoe	gelatinoid
!	gelatinous
jntr	gender

# Page 87 Column 1
jen^o(	genealogy
jen	general
!	generalissimo
jen^l	generality
!	generalization
jenliz	generalize
jene	generally
jen^sh	generalship
jenrt	generate
jenrt-d	generated
jenrts	generates
jenrash	generation
!	generative
jenrtr	generator
prjenetr	progenitor
re~jenrat	regenerate
jenrk	generic
jenrs	generous
jenr^s	generosity
jenss	genesis
jenl	genial
kjenl	congenial
jen^l	geniality
jene|	genially
jenetv	genitive

# Page 87 Column 2
jntel	genteel
jensh	gentian
jntil	Gentile
jntl	gentle
jnt^l	gentility
jnt	gentleman
jnt	gentlemen
jntln	gentleness
jnte	gently
jntre	gentry
jenfl	genuflect
jenflsh	genuflection
jenun	genuine
jenunn	genuineness
jenus	genus
jeod^a	geodetic
j^oe	geography
j^o(	geology
jeom	geometry
je~m	germ
je~msi	germicide
je~mnl	germinal
je~mnat	germinate
je~mnsh	germination
!	germinative

# Page 87 Column 3
jernd	gerund
jerntv	gerundive
jes(o	gesso
jestek^u	gesticulate
jestr	gesture
gisr	geyser
gas(te	ghastly
gos(t	ghost
gos(te	ghostly
jint	giant
geft	gift
gef^t	gifted
jigant	gigantic
geld	gild
!	gilded
!	gilder
jel	gill
gemle	gimlet
jenje~	ginger
jeraf	giraffe
ge~d	gird
ge~de~	girder
ge~dl	girdle
gl	girl
gl^d	girlhood

# Page 88 Column 1
glsh	girlish
gerth	girth
ge	give
fge	forgive
!	gave
ge	given
ger	giver
glashe~	glacier
glashl	glacial
gl	glad
gl^n	gladden
!	gladdened
gle	gladly
gln	gladness
!	gladsome
gladtr	gladiator
!	gladiatorial
gladilus	gladiolus
glamr	glamour
!	glamorous
glas	glass
glas(f	glassful
!	glassiness
glashe~	glazier
glef	gleeful

# Page 88 Column 2
glid	glide
!	glided
!	glider
glems	glimpse
!	glissando
glesn	glisten
!	glistened
glob	globe
!	globular
globl	globule
glum	gloom
!	gloomily
!	gloominess
glo	glory
glos	glories
glofsh	glorification
glof	glorify
glos	glorious
n-glos)	inglorious
glosare	glossary
glosen	glossiness
glv	glove
glukos	glucose
glu	glue
glutn	glutton

# Page 88 Column 3
glutnus	gluttonous
!	gnarled
nat	gnat
no	gnaw
!	gneiss
nom	gnome
nomn	gnomon
!	gnu
g	go
!	gocart
gn	gone
got	goat
gob	gobble
goble	goblet
god	God
!	godchild
gdes	goddess
gd-fath	godfather
!	godhead
!	godhood
gdl	godless
gdla	godlike
!	godling
gde	godly
!	godparent

# Page 89 Column 1
gds(en	godsend
!	goggle
goete~	goiter
gold	gold
goldn	golden
!	goldenrod
!	goldfish
!	goldsmith
golf	golf
!	golfer
gontla	gondola
gondler	gondolier
g	good
gbi	good-by
g^enes	goodliness
g^e	goodly
gnes	goodness
gus	goose
!	gooseberry
!	gopher
gorj	gorge
gojus	gorgeous
gorela	gorilla
gospl	gospel
gosame~	gossamer

# Page 89 Column 2
gosep	gossip
ga_sh	gouache
gauj	gouge
god	gourd
gv	govern
gv^b	governable
gves	governess
gv	government
gv^m	governmental
gv^r	governor
!	misgovern
n-gv	ungovernable
gras	grace
grasf	graceful
grasl	graceless
grashus	gracious
gra	grade
degra	degrade
gradsh	gradation
gratnt	gradient
!	ungraded
grad	gradual
gradle	gradually
gradeut	graduate
gradeutd	graduated

# Page 89 Column 3
gradeush	graduation
u^gradeut	undergraduate
gran	grain
granre	granary
grame~	grammar
gra~ma~n	grammarian
gram^a|	grammatical
g^	grand
a|^dis	aggrandize
g^chil-d^	grandchild
g^ur	grandeur
g^fath^	grandfather
g^elok	grandiloquence
g^elok	grandiloquent
g^os	grandiose
!	grandly
!	grandness
g^parent^	grandparent
granet	granite
grant	grant
gran^u	granulate
granul	granule
grap	grape
!	grapefruit
!	grapeshot

# Page 90 Column 1
!	grapevine
grafk	graphic
graf^k	graphical
!	graphics
!	graphophone
grapl	grapple
gras(opr	grasshopper
gratf	grateful
grat^f	gratification
gradf	gratify
grates	gratis
grat	gratitude
gratutus	gratuitous
gratute	gratuity
n-grat	ingrate
n-grat	ingratitude
n-gratf	ungrateful
gravmn	gravamen
gravl	gravel
gravta	gravitate
gravtsh	gravitation
gr^v	gravity
gres	grease
!	greasewood
!	greasily

# Page 90 Column 2
gresen	greasiness
gr	great
grr	greater
grs(t	greatest
gre	greatly
grnes	greatness
gred	greed
!	greedier
!	greediest
!	greedily
greden	greediness
gren	green
!	greener
!	greenery
!	greenhorn
!	greenhouse
grensh	greenish
!	greenroom
gregar	gregarious
!	Gregorian
gredirn	gridiron
gref	grief
grevns	grievance
grevus	grievous
gremas	grimace

# Page 90 Column 3
!	grimy
grint	grind
!	grinder
!	grindstone
gront	groaned
groser	grocer
grosere	grocery
grum	groom
!	groomed
grotesk	grotesque
grnt	ground
bakgr	background
fgrnt	foreground
grntl	groundless
grntrk	groundwork
u^gr	underground
grup	group
grovl	grovel
gro	grow
!	grower
gron	grown
graul	growl
grub	grub
grj	grudge
grul	gruel

# Page 91 Column 1
grusm	gruesome
gruf	gruff
grmb	grumble
grnt	grunt
ga~nte	guarantee
ga~nted	guaranteed
ga~ntr	guarantor
ga~d	guard
ga~d-d	guarded
ga~da&e~n	guardian
!	guardsman
!	guava
!	gubernatorial
ge~tn	guerdon
grela	guerrilla
gid	guide
gitns	guidance
!	guidebook
gid-d	guided
!	guild
gil	guile

# Page 91 Column 2
bgi	beguile
!	guillotine
gelt	guilt
glte|	guiltily
!	guiltiness
geltl	guiltless
gelte	guilty
gene	guinea
gis	guise
geta~	guitar
gule	gullet
gulb	gullible
glp	gulp
gm	gum
gn	gun
!	gunboat
!	guncotton
!	gunfire
!	gunman
!	gunner
!	gunnery

# Page 91 Column 3
!	gunpowder
!	gunshot
!	gunsmith
gns(to	gunstock
gnl	gunwale
gergl	gurgle
gsh	gush
!	gusher
gus(et	gusset
gust	gust
!	gusto
gute~	gutter
gutrl	guttural
jem-nas	gymnasium
jem-nas	gymnast
jem-n^s(t	gymnastic
jeps(m	gypsum
jepse	gypsy
jira	gyrate
!	gyratory
!	gyroscope

