# Page 121 Column 1
labl	label
laba&'l	labial
labr	labor
lab^re	laboratory
labrd	labored
!	laborer
labrus	laborious
labenum	laburnum
labrenth	labyrinth
lasera	lacerate
!	lacerated
!	laceration
!	lachrymal
!	lachrymose
lakr	lacquer
lakros	lacrosse
laktek	lactic
lakeuna	lacuna
!	lacunae
!	lacunas
lade~	ladder
latn	laden
ladl	ladle
lade	lady

# Page 121 Column 2
ladela	ladylike
!	ladyship
laga~d	laggard
lagun	lagoon
late	laity
lambent	lambent
lam	lame
!	lamed
!	lamely
!	lameness
lamn-t	lament
!	lamentable
!	lamentation
!	lamented
lamna	lamina
!	laminate
!	laminated
!	lamination
lampun	lampoon
!	lamprey
lanset	lancet
!	lancination
lant	land
lantd	landed
!	landfall

# Page 121 Column 3
lantoldr	landholder
lantlade	landlady
!	landlocked
lantlod	landlord
!	landmark
!	landowner
lants(kp	landscape
lantslep	landslip
!	landsman
land^d	landward
lang	language
lange_d	languid
langsh	languish
langr	languor
!	languorous
lantn	lantern
!	lanthanum
!	lanyard
lapl	lapel
lapdre	lapidary
laps	lapse
larbod	larboard
lars-ne	larceny
lars-nus	larcenous
!	larch

# Page 122 Column 1
la~d	lard
laj	large
nlaj	enlarge
laje	largely
laje~	larger
lajes	largest
lara&'t	lariat
lark	lark
larkspur	larkspur
larva	larva
!	larval
larenkx	larynx
larenji	laryngitis
lastu	lassitude
laso	lasso
las	last
lasd	lasted
lase	lastly
las-s	lasts
lach	latch
lachke	latchkey
!	latchstring
lat	late
late	lately
lat-n	lateness

# Page 122 Column 2
late~	later
lates	latest
late~	latter
latn-t	latent
latl	lateral
!	laterally
lath	lath
lath	lathe
lath	lather
latn	Latin
!	Latinism
latnes	Latinist
lat^nt	Latinity
latet	latitude
latetutnl	latitudinal
late~	latter
latemo	lattermost
lates	lattice
!	latticework
lod	laud
lod^b	laudability
lodb	laudable
lodsh	laudation
lodre	laudatory
lotnum	laudanum

# Page 122 Column 3
laf	laugh
lafb	laughable
!	laughingstock
lafte~	laughter
lonch	launch
londr	launder
!	laundress
lontre	laundry
!	laundryman
lorel	laurel
lora&'t	laureate
lava	lava
!	lavaliere
lavtre	lavatory
lavndr	lavender
lavesh	lavish
lo	law
lof	lawful
!	lawgiver
lol	lawless
!	lawmaker
!	lawsuit
lor	lawyer
laks	lax
!	laxative

# Page 123 Column 1
lakste	laxity
laxn	laxness
rlaks	relax
lar	layer
lase	lazy
!	lazily
lazen	laziness
led	lead
letn	leaden
le~de~	leader
le~de~sh	leadership
!	leadsman
leg	league
lek	leak
lekj	leakage
leken	leakiness
len	learn
len^t	learned
len-t	learnt
les	lease
les(old	leasehold
!	leaseholder
lese	lessee
les(or	lessor
les(t	least

# Page 123 Column 2
leth	leather
leth^et	leatheret
!	leathern
lethoe	leatheroid
!	leatherwood
!	leathery
levn	leaven
lektn	lectern
lektr	lecture
lekt^r	lecturer
le~je~	ledger
le^d	leeward
le^ua	leeway
lft	left
!	left-handed
legse	legacy
leg	legal
eleg	illegal
legs(m	legalism
leg^l	legality
legezsh	legalization
legiz	legalize
!	legally
legat	legate
legate	legatee

# Page 123 Column 3
legsh	legation
!	legato
lejnt	legend
lejndre	legendary
lejtman	legerdemain
!	legging
lejb	legible
elejb	illegible
lej^b	legibility
lejn	legion
lejnre	legionary
lj	legislate
lj	legislation
ljv	legislative
lj^r	legislator
ljt	legislature
ljtmat	legitimate
elejtmat	illegitimate
!	legitimacy
!	legitimateness
ljtmsh	legitimation
!	legitimatize
ljtmes	legitimist
!	legume
!	leguminous

# Page 124 Column 1
leshu	leisure
!	leisureliness
!	leisurely
lemn	lemon
lemnad	lemonade
!	lemur
leng	length
lengn	lengthen
!	lengthily
!	lengthiness
!	lengthways
lengi	lengthwise
!	lengthy
lenent	lenient
!	lenience
!	leniently
lenedf	lenitive
l^nt	lenity
lent	Lent
!	Lenten
!	lentil
lentek	lenticular
lenin	leonine
lepe~d	leopard
!	leper

# Page 124 Column 2
leprse	leprosy
!	leprous
!	lesion
les	less
les(t	least
les(n	lessen
lesnd	lessened
leser	lesser
les(n	lesson
le	let
!	lethal
lethje	lethargy
!	lethargic
!	lethargical
le	letter
led	lettered
le^ed	letterhead
le^pres	letterpress
letus	lettuce
levnt	levant
leve	levee
levl	level
levl-d	leveled
!	leveler
levr	lever

# Page 124 Column 3
levrj	leverage
levithan	leviathan
!	levitate
!	levitation
l^v	levity
lexkn	lexicon
lex^oe	lexicography
lib	liable
li^b	liability
!	liaison
la&er	liar
!	libation
libl	libel
!	libelant
!	libeled
lible	libelee
liblr	libeler
!	libelous
leber	liberal
eleber	illiberal
leber-sm	liberalism
leb^l	liberality
!	liberalization
!	liberalizer
lebra|	liberally

# Page 125 Column 1
leb	liberty
lebera	liberate
leberad	liberated
leberash	liberation
leberar	liberator
librre	library
libra&'n	librarian
lebreto	libretto
lis(ns	license
lis(nsd	licensed
!	licensee
lis(nsha&'t	licentiate
likn	lichen
lekres	licorice
!	lictor
lej	liege
len	lien
lu	lieu
lutnnt	lieutenant
laf	life
lafl	lifeless
lafla	lifelike
laflng	lifelong
laftm	lifetime
lavs	lives

# Page 125 Column 2
left	lift
lig	ligate
legm	ligament
!	ligation
legatr	ligature
li	light
ali	alight
dlif	delightful
nlinm	enlightenment
li^t	lighted
lin	lighten
!	lightened
lir	lighter
lis(t	lightest
l'is	lighthouse
la&e	lightly
!	light-minded
li^n	lightness
lin'	lightning
lis	lights
!	lightship
lis(m	lightsome
reli	relight
legnus	ligneous
legnf	lignify

# Page 125 Column 3
legni	lignite
la	like
dsla	dislike
la^b	likable
lae^d	likelihood
lae	likely
lan	liken
lan-d	likened
la^n	likeness
las	likes
la&es	likewise
nlae	unlikely
lilak	lilac
!	lilt
lele	lily
lembr	limber
lim	lime
!	limekiln
!	limelight
!	limewater
lemet	limit
lemetb	limitable
lemsh	limitation
lemetd	limited
lemetl	limitless

# Page 126 Column 1
lems(en	limousine
lempd	limpid
lempdte	limpidity
lentn	linden
lan	line
alin	align
lenj	lineage
lenl	lineal
lenam	lineament
lena&e~	linear
lan-d	lined
!	lineman
lane~	liner
relan	reline
nlant	unlined
lenen	linen
lenge~	linger
lanshre	lingerie
lengl	lingual
lenge_s	linguist
leng^st	linguistic
leng^s(ts	linguistics
lenem	liniment
lenkj	linkage
lenol	linoleum

# Page 126 Column 2
lanotip	linotype
lentl	lintel
la&en	lion
!	lioness
!	lionize
leke_d	liquid
leke_fksh	liquefaction
leke_f^b	liquefiable
leke_f	liquefy
leke_s(nt	liquescent
leke_td	liquidate
leke_dsh	liquidation
leke_dtr	liquidator
!	liquidity
lekr	liquor
lera	lira
lera	lire
les(m	lissom
ls	list
nls	enlist
lsl	listless
ls-s	lists
!	reenlist
les(n	listen
les(n-d	listened

# Page 126 Column 3
les(nr	listener
le~te~	liter
!	literate
elet	illiterate
letse	literacy
letl	literal
le^lsm	literalism
let^l	literality
le^siz	literalize
letre	literary
letr	literature
t^let	transliterate
letharj	litharge
lith	lithe
!	lithesome
letha&'	lithia
lethm	lithium
leth^o	lithograph
leteg	litigate
!	litigable
!	litigant
letsh	litigation
!	litigious
let-mus	litmus
le~te~	litter

# Page 127 Column 1
let	little
letrl	littoral
letje	liturgy
!	liturgic
lav	live
lav	live
lavd	lived
lave^d	livelihood
laven	liveliness
!	livelong
lavr	liver
lavre	livery
levd	livid
leza~d	lizard
lof	loaf
!	loaves
lom	loam
loth,	loathe
!	loathful
!	loathly
!	loathsome
lobe	lobby
!	lobbyist
lob-ste~	lobster
lok	local

# Page 127 Column 2
!	localism
lok^l	locality
!	localization
lokis	localize
loka|	locally
lok	locate
alok	allocate
dslok	dislocate
loksh	location
lok	lock
lokr	locker
loket	locket
!	lockjaw
lokau	lockout
!	locksmith
lokmosh	locomotion
lokmodf	locomotive
lokus	locus
!	loci
lokus	locust
loj	lodge
!	lodger
!	lodgment
loft	loft
lofte|	loftily

# Page 127 Column 3
loften	loftiness
!	logarithm
!	loggia
lojk	logic
eloj^k	illogical
lojkl	logical
lojesh	logician
!	logotype
!	logwood
loete~	loiter
!	loitered
!	loiterer
lon	lone
lonenes	loneliness
lons(m	lonesome
!	lonesomeness
lng	long
blng	belong
elongat	elongate
!	longboat
lng^t	longed
lnge~	longer
lnges	longest
lnjvte	longevity
!	longhand

# Page 128 Column 1
!	longhorn
lnjtu	longitude
!	longitudinal
!	longshoreman
prlng	prolong
lu	look
aulu	outlook
lup	loop
lup'ol	loophole
lus	loose
lusn	loosen
lus(nt	loosened
lusnes	looseness
loka_sh	loquacious
lok^s	loquacity
lod	lord
!	lordliness
lodsh	lordship
lor	lore
lornet	lorgnette
lus	lose
!	losable
los	loss
los(t	lost
lotre	lottery

# Page 128 Column 2
lotus	lotus
lau	loud
laur	louder
laus(t	loudest
laue	loudly
!	loudness
lnj	lounge
lv	love
!	lovable
lvl	loveless
lven	loveliness
lve	lovely
lvr	lover
!	lovesick
!	unlovable
lo	low
lobon	lowborn
!	lowboy
lor	lower
!	lowermost
los(t	lowest
loland	lowland
lo,en	lowliness
!	lowness
!	low-pressure

# Page 128 Column 3
lospr^t	low-spirited
loe	loyal
loe^s(t	loyalist
loe	loyalty
lbrek	lubricate
!	lubricant
lbreksh	lubrication
lbrekatr	lubricator
lus(nt	lucent
lus(ed	lucid
lusedte	lucidity
luk	luck
!	luckily
luken	luckiness
lukl	luckless
luktv	lucrative
lukbrash	lucubration
ludek	ludicrous
lugj	luggage
lugub	lugubrious
luko_m	lukewarm
lmbgo	lumbago
lmbr	lumber
lumnus	luminous
lumnre	luminary

# Page 129 Column 1
!	luminescent
lumn^s	luminosity
lmp	lump
luna~	lunar
lunse	lunacy
lun^a	lunatic
lnch	lunch
lnchn	luncheon
lrch	lurch
lr	lure

# Page 129 Column 2
lred	lurid
lrk	lurk
lshus	luscious
luste~	luster
!	lustrous
!	lute
!	Lutheran
lux	luxury
lux^ns	luxuriance
luxnt	luxuriant

# Page 129 Column 3
luxt	luxuriate
luxus	luxurious
lis(em	lyceum
lemf^a	lymphatic
lenks	lynx
la&enas	lyonnaise
lir	lyre
lerk	lyric
!	lyrical
lerss	lyricism

