# Page 254 Column 1
uob	wabble
uodl	waddle
uafr	wafer
uofl	waffle
uaft	waft
uaj	wage
uaje~	wager
vagnere&'n	Wagnerian
uagn	wagon
uast	waist
uakf	wakeful
uok	walk
uokr	walker
ueokau	walkout
uolnut	walnut
uolrus	walrus
uolts	waltz
uompm	wampum
uondr	wander
ont	want
nontt	unwanted
uo	war
uofar	warfare
uola	warlike

# Page 254 Column 2
uopath	warpath
uo^r	warrior
uo^sh	warship
uod	ward
uodn	warden
uodrob	wardrobe
uars)	warehouse
uom	warm
uomd	warmed
uomth	warmth
uon	warn
uond	warned
uop	warp
uont	warrant
nuontb	unwarrantable
uontd	warranted
uontr	warrantor
uonte	warranty
uoren	warren
uare	wary
nuare	unwary
os	was
uosh	wash
nuosht	unwashed
uoshb	washable

# Page 254 Column 3
uoshe~	washer
uoshau	washout
uoshstn	washstand
uosp	wasp
uosel	wassail
uast	waste
uastj	wastage
uastbasket	wastebasket
uastf	wasteful
uastrel	wastrel
uoch	watch
uochkas	watchcase
uochdog	watchdog
uochf	watchful
uochmakr	watchmaker
uochman	watchman
uochtaur	watch tower
uochud	watchword
uote~	water
uote~^krs	watercourse
uotefo	waterfall
uoterfaul	waterfowl
uotelogd	water-logged
uotemark	watermark
uotemeln	watermelon

# Page 255 Column 1
uotershed	watershed
uote~tit	water-tight
uotera_	waterway
uoterks	waterworks
uote~e	watery
uot	watt
uotj	wattage
uot-mete~	wattmeter
uavr	waver
nuavr'	unwavering
uax	wax
uaxt	waxed
uaxn	waxen
uaxenes	waxiness
ua	way
uabl	waybill
uafarr	wayfarer
uasi	wayside
ua^d	wayward
ek	weak
ekn	weaken
eknd	weakened
ekl'	weakling
eke	weakly
eknes	weakness

# Page 255 Column 2
lth	wealth
lthe|	wealthily
uepn	weapon
uere	weary
uere|	wearily
ueresm	wearisome
uesl	weasel
ueth	weather
uethbetn	weather-beaten
uethkk	weathercock
uethprf	weatherproof
ueb	web
ek	week
ekda	weekday
eknd	week-end
eke	weekly
uep	weep
uat	weight
uerd	weird
lkm	welcome
nlkm	unwelcome
l	well
nl	unwell
lfar	welfare
lbon	well-born

# Page 255 Column 3
lfa^t	well-favored
uelte~	welter
er	were
ues	west
uesre	westerly
uestn	western
uestnr	westerner
ues^d	westward
uet	wet
uet-nes	wetness
'uak	whack
'ual	whale
'ualbak	whaleback
'ualbon	whalebone
'uof	wharf
'uofj	wharfage
'uofnje~	wharfinger
'uovs	wharves
ot	what
smot	somewhat
otev	whatever
ot-n	whatnot
otsov	whatsoever
'uet	wheat
'uetn	wheaten

# Page 256 Column 1
'uetuum	wheatworm
'uel	wheel
en	when
enev	whenever
ensov	whensoever
'uens	whence
ar	where
arabs	whereabouts
ars)	whereas
a~t	whereat
arb	whereby
arf	wherefore
arfm	wherefrom
a~n	wherein
aro	whereof
aron	whereon
arsov	wheresoever
arpon	whereupon
arev	wherever
areth(	wherewith
areth(o(	wherewithal
ueth	whether
ch	which
chev	whichever
chsov	whichsoever

# Page 256 Column 2
il	while
ilm	whilom
ils	whilst
'uem	whim
'uems^k	whimsical
'uemsk^l	whimsicality
'uin	whine
'uep	whip
'uepkod	whipcord
'uepet	whippet
'uep-sto	whipstock
'uerl	whirl
'uerlpul	whirlpool
'uerle_nd	whirlwind
'uesk	whisk
'ueske	whisky
'uespr	whisper
'uest	whist
'uesl	whistle
'uit	white
'uitkap	whitecap
'uitfesh	whitefish
'uitn	whiten
'uit-n	whiteness
'uituud	whitewood

# Page 256 Column 3
'ueth	whither
'uetl	whittle
'u	who
'uv	whoever
'ol	whole
un'ol-sm	unwholesome
'ola~td	whole-hearted
'olsa	wholesale
'olsa^r	wholesaler
'ol-sm	wholesome
'ole	wholly
'uup	whoop
'us	whose
i	why
ueked	wicked
ueked-nes	wickedness
uekrrk	wickerwork
ueket	wicket
uid	wide
uidn	widen
uid-nes	wideness
uidspred	widespread
uedth	width
uedo	widow
uedod	widowed

# Page 257 Column 1
uedor	widower
uedo^d	widowhood
ueld	wield
nuelde	unwieldy
if	wife
uega_g	wigwag
uego_m	wigwam
uild	wild
ueldrnes	wilderness
uildfir	wildfire
uildnes	wildness
l	will
nl'	unwilling
lf	willful
uelo	willow
uile	wily
uench	winch
uind	wind
uend	wind
uendj	windage
uendbrak	windbreak
uendfo	windfall
uende|	windily
uend-mel	windmill
uendo	window

# Page 257 Column 2
uin	wine
uin-glas	wineglass
ueng	wing
uengl	wingless
uenk	wink
uene~	winner
uentr	winter
uip	wipe
uipr	wiper
ir	wire
irl	wireless
irpul'	wirepulling
uis	wise
nuis	unwise
ues(dm	wisdom
uise	wisely
uisr	wiser
uises	wisest
ush	wish
nusht	unwished
ushe~	wisher
ushf	wishful
uestara&'	wistaria
uet	wit
nuet'	unwitting

# Page 257 Column 3
uetss	witticism
uete|	wittily
uetenes	wittiness
uech	witch
uechre	witchery
eth	with
neths	notwithstanding
ethen	within
etht	without
ethdro	withdraw
ethdrol	withdrawal
ethdron	withdrawn
ethdru	withdrew
eth'old	withhold
eth('eld	withheld
ethstn	withstand
ethstu	withstood
uet-nes	witness
uezad	wizard
uezadre	wizardry
uo	woe
uobgn	woebegone
uof	woeful
uulf	wolf
uulfaund	wolfhound

# Page 258 Column 1
uulfsh	wolfish
uulveren	wolverine
uulvs	wolves
umn	woman
numne	unwomanly
umn^d	womanhood
umn-ki	womankind
umnla	womanlike
umnenes	womanliness
umne	womanly
uemn	women
un	won
uun	wonder
uunf	wonderful
uunland	wonderland
uunm	wonderment
uun-strkn	wonderstricken
uunrk	wonderwork
uunus	wondrous
ont	won't
ont	wont
nontd	unwonted
uu	woo
uud	wooed
uur	wooer

# Page 258 Column 2
uud	wood
uudkraft	woodcraft
uudkut	woodcut
uudd	wooded
uudn	wooden
uudland	woodland
uud-mn	woodman
uudpekr	woodpecker
uudsman	woodsman
uudrk	woodwork
uuduum	woodworm
uuf	woof
uul	wool
uulen	woolen
ud	word
udd	worded
ude|	wordily
udenes	wordiness
uor	wore
rk	work
rerk	rework
nrkb	unworkable
rkb	workable
rkda	workaday
rkt	worked

# Page 258 Column 3
rk^r	worker
rk'us	workhouse
rkman	workman
rkman^sh	workmanship
rkshop	workshop
rktab	worktable
uu	world
nuue	unworldly
uuenes	worldliness
uue	worldly
uum	worm
'ukuum	hookworm
uumetn	worm-eaten
uum'ol	wormhole
uumud	wormwood
uue	worry
uued	worried
uuem	worriment
uuesm	worrisome
uus	worse
uust	worst
uu^sh	worship
uu^sh^r	worshiper
uu^shf	worshipful
uu^sh^t	worshipped

# Page 259 Column 1
uustd	worsted
uuth	worth
nuuthe	unworthy
uuthe|	worthily
uuthenes	worthiness
uuth(l	worthless
uuthe	worthy
d	would
uund	wound
uundd	wounded
uaund	wound
uov	wove
rath	wraith
rangl	wrangle
rath	wrath
rathf	wrathful

# Page 259 Column 2
reth	wreath
rek	wreck
sh^rek	shipwreck
rekj	wreckage
rekr	wrecker
rench	wrench
rest	wrest
resl	wrestle
reslr	wrestler
rech	wretch
rechd-nes	wretchedness
regl	wriggle
ri	wright
melri	millwright
plari	playwright
sh^ri	shipwright

# Page 259 Column 3
reng	wring
renge~	wringer
renkl	wrinkle
rest	wrist
ret	writ
ri	write
reri	rewrite
rir	writer
retn	written
rong	wrong
rongd	wronged
rongf	wrongful
rong'ed	wrong-headed
ronge	wrongly
rongnes	wrongness
roth	wroth

