# Page 260 Column 3
zel	zeal
zelot	zealot
zelotre	zealotry
zelus	zealous
zebra	zebra
zebu	zebu
zeneth	zenith
zefr	zephyr
zeplen	Zeppelin
zero	zero
zest	zest
zegzag	zigzag
z(enk	zinc
za&en	Zion
zerkn	zircon
zerknem	zirconium
zeth	zither
zoda&'k	zodiac
zon	zone
zo^o(	zoology
ze_bak	zwieback

